202211110000000
000000010000000
000000010000000
000000010000000
000000010000000
000000010000000
000000010000000
000001110000000
000000000001000
000001010001000
000000000001000
000000010000000
000000010001000
000000010001000
000000000111000
000111110100000
000100000100000
000000000000000
000100011100000
000000000000000
